# Room data, imported from KRD.
# This file was automatically generated by kconvert.py.


segment
name: Z01.2
width: 12
height: 12
data:
68  2 15  2  2  2  2  2  2  2 66 66 
68  2 74  8 74 74 74 74 74  2 24 66 
68  2 74  2  4 49 51 49  5  2 24 24 
68  2 74  2 74 83 81 85 74  2 66 66 
68  2 25  2 74 49 82 49 74  2 75  2 
 7  2  2  2 74 74 74 74 74  2 66 66 
66 17 72  2 74 49 74 49 74  2 39 66 
66 17 66  2 74 74 74 74 74  2  2  7 
66 17 72  2 74 49 74 49 74  2 26 66 
66 17 59  2 74 74 74 74 74  2 66 66 
66  3  7  2  2  2  9  2  2  2 66 66 
66 66 59  8 66 72 59 66 72  8 59 66 
rooms:
8
0 0 3 7 
2 1 3 6 
4 1 7 11 
10 0 4 6 
10 5 4 4 
10 8 4 6 
4 11 7 3 
0 6 5 8 
end

segment
name: Z02.2
width: 12
height: 12
data:
66 66  8 68 65 68 65 68  8 66 66 39 
66 66  2  2  2  2  2  2  2 66 66 66 
26 66  2 74 74 74 74 74  2 39 66 23 
 2  7  2 74 74 74 74 74  2  2  7  2 
68 68  2 74 74 51 74 74  2 26 66 66 
68 68  2 74 74 74 74 74  2 40 66 66 
68 66  2 74 74 74 74 74  2 42 66 66 
66 59  2  2  2 74  2  2  2 68 68 66 
66 72 10 74 74 74  2 72  8 66 68 44 
 7  2  2  2  2  2  2  2  2 66 68 39 
66  8 66 59 66 66 66 66  8 66 68 66 
39  2  6 72 66 72 66 39  2 66 66 66 
rooms:
10
0 0 4 5 
3 0 7 3 
9 0 5 5 
3 2 7 7 
0 4 4 7 
3 8 5 3 
7 8 3 3 
9 4 5 10 
2 10 8 4 
0 10 3 4 
end

segment
name: Z03.2
width: 12
height: 12
data:
66 66 66 66  2  2  2  2  2  2  2  2 
66 66 39 66  2  2  2  2  2  2  2  2 
66 25 45 68  2 74  8 74 75 74  2  2 
 7 16  3 75  2  7  2 75 51 75  2  2 
59 66 17 68  2 74  2 74 75 74  2  2 
66 72  3 75  2  7  2 75 74 75  2  2 
 6 59 17 68  2 15  2 74 75 74  2  2 
 2  2  2  7  2  2  2 75 74 75  2 39 
66 27  2 66 66 59  2 74 75 74  2 66 
66 66  8 71 69 71 10 75 74 75  2 66 
66 24  2 66 70 66  2  2  2  2  2  7 
24 24  2 66 66 66  8 66 68 68 66 66 
rooms:
12
0 0 6 9 
5 0 7 3 
11 0 3 6 
7 2 5 10 
0 8 4 6 
3 8 5 6 
7 11 7 3 
11 7 3 5 
11 5 3 3 
5 2 3 3 
5 4 3 3 
5 6 3 3 
end

segment
name: Z04.2
width: 12
height: 12
data:
66 66 66 66 66 83 81  2 23 66 66 66 
66 67 66 66 66  3 81  2 68 68 66 66 
66 40 66 40 66 83 81  8 85 68 24 66 
66 41 69 41 66 66 82  2 68 24 24 66 
69 41 66 41 66 67 66  2  2  2  2  2 
66 42 66 41 66 40 66  2 74 74 74  2 
66 66 66 42 69 41 66  2 74 51 74  2 
26 66 66  3 66 42 66  2 74 74 74  2 
66 66 66 66 66 66 66  2  4 84  5  2 
 2  2  7  2  2  2  2  2 72 66 59  2 
66 66 66  2 27  2 27  2  2  9  2  2 
66 66 66  8 66  8 66  8 66 72 66 66 
switches:
2
1 1 1 shoot 3 0 8 1
5 4 1 shoot 3 0 5 1
rooms:
8
0 0 9 11 
8 0 6 6 
8 5 5 5 
8 9 5 3 
8 11 6 3 
6 10 3 4 
4 10 3 4 
0 10 5 4 
end

segment
name: Z05.2
width: 12
height: 12
data:
66  8 66 66 66 66  2 68 68 68 68 68 
 2  2 24 24 66 66  8 68  3 68  3 68 
 2  2 23 24 24 25  2 68 68 68 68 68 
 2  2  2  2  2  2  2  2  2  2  7  2 
 2  2 74 75 74 75 74 75 74  2 68 39 
 2  2 75  4 75 51 75  5 75  2 68 68 
 2  2 74 75 74 75 74 75 74  2 39 68 
 2  2  2  2 75  2 75  2  2  2  2  7 
66 83 59 10 74 75 74 10 72 85 66 66 
66 68 82  2  2  2  2  2 82 68 69 66 
66 59 72  8 66 66 66  8 66 72 66 66 
 6 69 66  2 66 45 25  2 69 66 66 66 
rooms:
11
0 0 3 3 
0 2 3 7 
2 0 6 5 
7 0 7 5 
10 4 4 5 
2 4 9 5 
0 8 5 6 
4 8 3 3 
6 8 3 3 
4 10 5 4 
8 8 6 6 
end

segment
name: Z06.2
width: 12
height: 12
data:
66 66 66 66  8 66 66 66  2 23 66 66 
66 66 24 24  2 39 66 66  8 66 66 66 
 2  7  2  2  2  2  2  9  2  2  2  2 
66 66 66 28  2 72 75 82 75 59  2  2 
 7  2  2  2  2 75 74 74 74 72  2  2 
69  2 72 66  8 85 74 51 74 66  2  2 
 7  2 66 28  2 75 74 74 74 69  2  2 
66  2 25 39  2 66 66 69 59 66  2  2 
 7  2  2  2  2  9  2  2  2  2  2  2 
66 66 66 66  2 68  2  2  2  2  2  2 
66 66 66 66  8 68  2  2  2  2  2  2 
66 66 66 66  2 39  2  2  2  2  2  2 
rooms:
12
0 0 6 4 
5 0 5 4 
9 0 5 4 
0 3 6 3 
0 5 3 3 
0 7 3 3 
2 5 4 5 
5 3 7 7 
11 3 3 7 
0 9 6 5 
5 9 3 5 
7 9 7 5 
end

segment
name: Z07.2
width: 12
height: 12
data:
 2  2  2  2 66 66 66  2 66 66 66 66 
 2  2  2  2 25 45 66  8 66 66 66 66 
 2  2  2  2  2  2  2  2  2  7  2  2 
 2  2  2  2 74 51 74  2 69 66  2  2 
 2  2  2  2 84  3 84  2 66 59  2  2 
66 66 28  2 74 74 74  2 16  7  2  2 
66 66 40  2 84  3 84  2 59 69  2  2 
66 66 41  2 74 74 74  2  6 72  2  2 
66 66 42  2  9  2  2  2  2  7  2  2 
66 66 83  8 66  8 85 66 66 66 66 66 
66 66 24  2  9  2 23 66 66 66 66 66 
66 24 24  2 15  2 26 66 66 66 66 66 
rooms:
12
0 0 5 6 
4 0 5 4 
8 0 6 4 
4 3 5 3 
4 5 5 3 
4 7 5 3 
8 3 4 7 
11 3 3 7 
6 9 8 5 
0 5 5 9 
4 9 3 3 
4 11 3 3 
end

segment
name: Z08.2
width: 12
height: 12
data:
27  2 66 66 66 66 66  2 66 66 66 66 
66  8 66 66 45 45 66  8 66 66 66 28 
 7  2  2  2  2  2  2  2  2  2  7  2 
66  2 39 66 85 75 83 66 39  2 72 66 
73  2 66 85 75 74 75 83 66  2 40 66 
66  2 85 75 74 51 74 75 83  2 42 72 
66  2 66 85 75 74 75 83 66  2 59 66 
66  2 39 66 85 75 83 66 66 10 72 66 
 7  2  2  2  2  2  2  2  2  2  7  2 
66 66 66  2 68  8 68 24 24 24 72 66 
66 70 66  2  7  2 68 24 24 66 66 66 
66 66 66  8 68  2 66 66 66 66 66 66 
rooms:
10
0 0 3 4 
2 0 7 4 
8 0 6 4 
0 3 3 7 
2 3 9 7 
10 3 4 7 
0 9 5 5 
4 9 3 3 
4 11 3 3 
6 9 8 5 
end

segment
name: Z09.2
width: 12
height: 12
data:
66 66 66 66 28  2 77 77 77 77 77 77 
66 66 69 72 66  8 77  5 39  4 39 77 
 7  2  2  2  2  2 77 39  5 39  4 77 
66  2 39 66 66 10 77 77 77 77 77 77 
72  2 66 66 66  2  2  2  2  2  7  2 
66  2 25 25 72  2 74 74 74  2 69 66 
 7  2  2  2  2  2 74 51 74  2 66 66 
59 10 59 72 59 10 74  1 74  2 66 40 
 7  2  2  2  2  2 74 74 74  2 66 42 
66 66 66 59 23  2  2  2  2  2  7  2 
74 74 72 74 66  2 24 24 24 66 66 75 
66 66 66 74 66  8 66 75 75 69 75 66 
rooms:
10
0 0 7 4 
6 0 8 6 
0 3 3 5 
2 3 5 5 
6 5 5 6 
10 5 4 6 
0 7 3 3 
2 7 5 3 
0 9 7 5 
6 10 8 4 
end

eof
